111111111111111111111111111111111111111
10010000000C110010000000C110010000000C1
10P001111100000000111110000000011111001
100011000000110001100000011000110000001
111111111110111111111111011111111111101
111111111110111111111111011111111111101
10010000000C110010000000C110010000000C1
100001111100110000111110011000011111001
100011000000110001100000011000110000001
111111111110111111111111011111111111101
111111111110111111111111011111111111101
10010000000C110010000000C110010000000C1
100001111100110000111110011000011111001
10001100000011000110000001100011000E001
111111111111111111111111111111111111111