111111
101C11
1CPCC1
10E111
111111